Gauge	KEYWORD1
setPosition	KEYWORD2
setSize	KEYWORD2
setDepth	KEYWORD2
setAutoRedraw	KEYWORD2
setVisible	KEYWORD2
setDisplay	KEYWORD2
setFGColor	KEYWORD2
setBGColor	KEYWORD2
setBorder	KEYWORD2
setBorderColor	KEYWORD2
setGutter KEYWORD2
setMargin KEYWORD2
pushBitmap	KEYWORD2
redraw	KEYWORD2
getDepth	KEYWORD2
textGauge	KEYWORD1
setHAlign KEYWORD2
setVAlign KEYWORD2
setFont	KEYWORD2
setCursor	KEYWORD2
setFormatString	KEYWORD2
setValue	KEYWORD2
tapeGauge KEYWORD1
setMinMax KEYWORD2
setColors KEYWORD2
setDirection KEYWORD2
